Base system: Debian Trixie
WM: Hyprland
	workspaces as in gnome (hycov)
Bar: waybar
	active workspace
	date and time
	system resource info
	input method
	network icon
	volume icon
	batery level
App launcher: wofi
Notifications: swaync
Lock screen: swaylock
Logout(power menu):
Wallpaper: swaybg
Shell: bash
Terminal: kitty
System monitor: bottom
File managers: yazi + nautilus
Promts: Starship
Text editor: micro
Color scheme: catppuccin | kanagawa | everforest
Font: Hack Nerd Mono
Cursor: Adwaita
Browser: chromebased
IDE: vscodium
Screenshot: grim + slurp 
Image viewer: qimgv
Video player: mpv
Screen brightness: gammastep
Clipboard: 
